-1 -1 -1 -1 -1 -1 -1 -1 -1 -1 -1 -1 -1 -1 -1 -1 -1 -1 -1 -1 -1 -1 -1 -1 -1 -1 -1 -1 -1 -1 -1 -1 -1 -1 -1 -1 -1 -1 -1 -1 -1 -1 -1 -1 -1 -1 -1 -1
-1 -1 -1 -1 -1 -1 -1 -1 -1 -1 -1 -1 -1 -1 -1 -1 -1 -1 -1 -1 -1 -1 -1 -1 -1 -1 -1 -1 -1 -1 -1 -1 -1 -1 -1 -1 -1 -1 -1 -1 -1 -1 -1 -1 -1 -1 -1 -1
-1 -1 -1 -1 -1 -1 -1 -1 -1 -1 -1 -1 -1 -1 -1 -1 -1 -1 -1 -1 -1 -1 -1 -1 -1 -1 -1 -1 -1 -1 -1 -1 -1 -1 -1 -1 -1 -1 -1 -1 -1 -1 -1 -1 -1 -1 -1 -1
-1 -1 -1 -1 -1 -1 -1 -1 -1 -1 -1 -1 -1 -1 -1 -1 -1 -1 -1 -1 -1 -1 -1 -1 -1 -1 -1 -1 -1 -1 -1 -1 -1 -1 -1 -1 -1 -1 -1 -1 -1 -1 -1 -1 -1 -1 -1 -1
-1 -1 -1 -1 -1 -1 -1 -1 -1 -1 -1 -1 -1 0 2 -1 -1 -1 -1 -1 -1 -1 -1 -1 -1 -1 -1 -1 0 1 2 -1 -1 -1 -1 -1 -1 -1 -1 -1 -1 -1 -1 -1 -1 -1 -1 -1
-1 -1 -1 -1 -1 -1 -1 -1 -1 -1 0 1 1 9 7 -1 -1 -1 -1 -1 -1 -1 -1 -1 -1 -1 -1 -1 4 5 6 -1 -1 -1 -1 0 2 -1 -1 -1 -1 -1 -1 -1 -1 -1 -1 -1
-1 -1 -1 -1 -1 -1 -1 -1 -1 -1 3 10 10 10 7 -1 -1 -1 -1 -1 -1 -1 -1 -1 0 1 2 -1 -1 -1 -1 -1 -1 -1 0 9 8 2 -1 -1 -1 -1 -1 -1 -1 -1 -1 -1
1 1 2 -1 -1 -1 0 1 2 -1 4 5 5 5 6 -1 -1 -1 -1 -1 -1 -1 0 1 9 10 7 -1 -1 -1 -1 0 1 1 9 10 10 8 1 1 1 1 1 1 1 1 1 1
10 10 7 -1 -1 -1 4 5 6 -1 -1 -1 -1 -1 -1 -1 0 2 -1 -1 0 1 9 10 10 10 7 -1 -1 -1 -1 3 10 10 10 10 10 10 10 10 10 10 10 10 10 10 10 10
1 1 1 1 1 2 -1 -1 -1 0 1 1 1 1 1 1 9 8 1 1 9 10 10 10 10 10 7 -1 -1 -1 -1 3 10 10 10 10 10 10 10 10 10 10 10 10 10 10 10 10
10 10 10 10 10 7 -1 -1 -1 3 10 10 10 10 10 10 10 10 10 10 10 10 10 10 10 10 7 -1 -1 -1 -1 3 10 10 10 10 10 10 10 10 10 10 10 10 10 10 10 10
10 10 10 10 10 7 -1 -1 -1 3 10 10 10 10 10 10 10 10 10 10 10 10 10 10 10 10 7 -1 -1 -1 -1 3 10 10 10 10 10 10 10 10 10 10 10 10 10 10 10 10