-1 -1 -1 -1 -1 -1 -1 -1 -1 -1 -1 -1 -1 -1 -1 -1 -1 -1 -1 -1 -1 -1 -1 -1 -1 -1 -1 -1 -1 -1 -1 -1 -1 -1 -1 -1 -1 -1 -1 -1 -1 -1 -1 -1 -1 -1 -1 24
-1 -1 -1 -1 -1 -1 -1 -1 24 18 19 -1 -1 -1 -1 -1 -1 -1 -1 -1 -1 -1 -1 -1 -1 -1 -1 -1 -1 -1 -1 -1 -1 -1 -1 -1 -1 -1 -1 -1 -1 -1 -1 -1 -1 -1 -1 24
-1 -1 -1 -1 -1 -1 -1 -1 24 27 28 -1 -1 -1 -1 -1 -1 -1 -1 -1 -1 -1 -1 -1 -1 -1 -1 -1 -1 24 -1 -1 2 -1 -1 -1 -1 -1 -1 -1 -1 -1 -1 -1 -1 -1 -1 24
-1 -1 -1 -1 -1 -1 -1 -1 24 36 37 -1 -1 -1 -1 -1 -1 -1 -1 -1 -1 -1 -1 -1 -1 -1 20 21 -1 24 -1 2 5 -1 -1 -1 -1 20 21 -1 -1 -1 -1 -1 -1 -1 -1 24
-1 -1 -1 -1 -1 -1 -1 -1 0 45 46 1 -1 -1 -1 -1 -1 -1 -1 -1 18 19 24 -1 -1 -1 29 30 24 -1 2 6 -1 -1 2 -1 -1 29 30 -1 -1 -1 -1 -1 0 7 7 7
-1 -1 -1 -1 -1 -1 -1 0 14 12 15 10 -1 -1 -1 -1 -1 -1 -1 -1 27 28 24 -1 -1 0 7 7 1 -1 5 -1 -1 -1 6 -1 0 7 1 -1 -1 -1 -1 0 14 12 12 12
-1 -1 -1 -1 -1 -1 0 14 12 12 16 5 0 1 -1 -1 -1 -1 -1 -1 36 37 24 24 -1 17 12 12 16 -1 -1 -1 -1 -1 -1 -1 9 8 10 -1 -1 -1 0 14 12 12 12 12
24 -1 -1 -1 -1 0 14 12 12 12 16 -1 9 10 -1 -1 -1 2 -1 0 45 46 7 7 7 14 12 12 16 11 11 11 11 11 11 11 5 6 5 -1 24 0 14 12 12 12 12 12
24 -1 -1 -1 0 14 12 12 12 12 16 -1 6 5 -1 2 -1 5 -1 17 12 12 12 12 12 12 12 12 13 7 7 7 7 7 7 7 7 7 7 7 7 14 12 12 12 12 12 12
22 22 22 22 12 12 12 12 12 12 16 11 11 11 11 11 11 11 11 17 12 12 12 12 12 12 12 12 12 12 12 12 12 12 12 12 12 12 12 12 12 12 12 12 12 12 12 12
23 23 23 23 12 12 12 12 12 12 13 7 7 7 7 7 7 7 7 14 12 12 12 12 12 12 12 12 12 12 12 12 12 12 12 12 12 12 12 12 12 12 12 12 12 12 12 12
23 23 23 23 12 12 12 12 12 12 12 12 12 12 12 12 12 12 12 12 12 12 12 12 12 12 12 12 12 12 12 12 12 12 12 12 12 12 12 12 12 12 12 12 12 12 12 12